<?xml version="1.0" encoding="utf-8"?>
<level>
  <tiles>RX....##....RX....##....RX
XX....##....XX....##....XX
..XX......XX..XX......XX..
..XX......XX..XX......XX..
....XX..XX######XX..XX....
....XX..XX######XX..XX....
##....QQ..##~~##..QQ....##
##....QQ..##~~##..QQ....##
....XX..XX######XX..XX....
....XX..XX######XX..XX....
..XX######XX..XX######QQ..
..XX######XX..XX######QQ..
QQ..##~~##..QQ..##~~##..QQ
QQ..##~~##..QQ..##~~##..QQ
..XX######XX..XX######QQ..
..XX######XX..XX######QQ..
....XX..XXXXXXXXXX..XX....
....XX..XXXXXXXXXX..XX....
##....QQ..XX~~XX..QQ....##
##....QQ..XX~~XX..QQ....##
....XXXXQQXXXXXXXXXXXX....
....XXXXQQXXXXXXXXXXXX....
..XXXXXX..........XXXXXX..
..XXXXXX...XXXX...XXXXXX..
XXXXQQ..1..Xs.X.2...XXXXXX
XXXXQQ.....X..X.....XXXXXX
</tiles>
</level>