<?xml version="1.0" encoding="utf-8"?>
<level>
  <tiles>R.........QQR.QQ........R.
..........QQ..QQ..........
XX......//XX..XXQQ..QQQQXX
XX......//XX..XXQQ..QQQQXX
XX....XX....QQ....XX....XX
XX....XX....QQ....XX....XX
XX..~~..~~......~~..~~..XX
XX..~~..~~......~~..~~..XX
..XX~~..~~XX..XX~~..~~XX..
..XX~~..~~XX..XX~~..~~XX..
....~~..~~~~..~~~~..~~....
....~~..~~~~..~~~~..~~....
......XXXXXXXXXXQQXX......
........XXXXXXXXQQ........
XX......QQ......XX......XX
XX......QQ..QQXXXX......XX
XX......XXXX..XXXX......XX
XX......XXXX..XXXX......XX
QQ......QQXXXX..XX......XX
QQ......QQ......XX......XX
XX..QQ..XXXXXXXXXX......XX
XX..QQXXXXXXXXXXXXQQ....XX
XXQQQQXXXX......XXXXXX..XX
XXQQQQXXXX.XXXX.XXXXXX..XX
QQ......1..Xs.X.2.......QQ
QQ.........X..X.........QQ
</tiles>
</level>