<?xml version="1.0" encoding="utf-8"?>
<level>
  <tiles>R...........R...........R.
..........................
....XX##........XX##....//
....XX##........XX##....//
//////..................//
//////..................//
//////..QQ~~XX..QQ////////
//////..QQ~~XX..QQ////////
....//XXXXXX~~XX....QQ//XX
....//XXXXXX~~XX....QQ//XX
##..////QQXXXXXX..XXXX//##
##..////QQXXXXXX..XXXX//##
QQ##////XXXXQQ........////
QQ##////XXXXQQ........////
XXXX##XXXX~~~~~~~~########
XXXX##XXXX~~~~~~~~########
....~~......####~~~~~~QQ##
....~~......####~~~~~~QQ##
..QQ~~..............~~XX##
..QQ~~..............~~XX##
XXXX~~..............~~XX##
XXXX~~..............~~XX##
XXXX~~..............~~XXXX
XXXX~~.....XXXX.....~~XXXX
XXXXQQ..1..Xs.X.2...XXXXXX
XXXXQQ.....X..X.....XXXXXX
</tiles>
</level>