<?xml version="1.0" encoding="utf-8"?>
<level>
  <tiles>R...####....R.....####..R.
....####..........####....
....####..XX..XX..####....
..XX####..XX..XX..####XX..
..XX##....XX..XX....##XX..
....##XX..XX..XX..XX##....
....##XX....QQ....XX##....
..XX##......QQ......##....
QQXXXX......XX......XXQQQQ
QQXXXX..XX..XX..XX..XXQQQQ
~~......QQ......XX........
~~........................
~~XXQQXX..........XXXXXX~~
~~XXQQXX..XXXXXX..XXXXXX~~
~~XX..XX..XXXXXX..##..XX~~
~~XX..XX..XX......##..XX~~
~~XX##XX....XX....##..XX~~
~~XX##XX....XX....##..XX~~
~~....XX......XX..XX..XX~~
~~....XX..XXXXXX..XX..XX~~
XXXXXXXX..XXXXXX..XXXXXX~~
XXXXXXXX..........XXXXXX~~
~~........................
~~.........XXXX...........
~~######1..Xs.X.2.QQ####..
~~######...X..X...QQ####..
</tiles>
</level>