<?xml version="1.0" encoding="utf-8"?>
<level>
  <tiles>R...........R.......XX..R.
....................XX....
....//XXXXXXXXXXXXXXXX..##
....//XXXXXXXXXXXXXXXXQQ##
~~~~////....XX......XX..##
~~~~////....XX......XX..##
##....//~~##XX##....XX..##
##..XX//~~##XX##QQQQXXQQ##
##XXXX//~~..XX......XX..##
##XXXX//~~..XX......XX..##
##XXXX//~~##XX##QQ..QQ..##
##XXXX//~~##XX##QQQQQQQQ##
QQ..XX//~~..XX..~~..XX..##
QQ..XX//~~..XX..~~..XX..##
##XXXX//####XX##XX..XX..##
##XXXX//####XX##XXQQXXQQ##
##XXXX//....XX//~~~~~~~~##
##XXXX//....XX//~~~~~~~~##
QQXXXXXXQQXXXX//////XXXXXX
QQXXXXXXQQXXXX//////XXXXXX
##..XX......XX......XXQQQQ
##..XX......XX......XXQQQQ
XXXXQQ..............XX....
XXXXQQ.....XXXX.....XX....
XXXXXX..1..Xs.X.2...XX....
XXXXXX.....X..X.....XX....
</tiles>
</level>