<?xml version="1.0" encoding="utf-8"?>
<level>
  <tiles>R.....QQ..XXR.XX..XX..QQR.
......QQ..XX..XX..XX..QQ..
##XX..QQ..........XX####..
##XX..QQ..........XX####..
//XX..XX..XXQQ..XXQQ##QQQQ
//XX..XX..XXQQ..XXQQ##QQQQ
//XX......~~~~////////////
//XX......~~~~////////////
//XXQQ..XXXX..XXXX..QQXX//
//XXQQ..XXXX..XXXX..QQXX//
////XX..QQ~~....QQ..~~XX//
////XX..QQ~~....QQ..~~XX//
QQ//QQ..XXXX..QQXX..XXXX//
QQ//QQ..XXXX..QQXX..XXXX//
XX//XX....XX~~~~~~~~XX##//
XX//XX....XX~~~~~~~~XX##//
##XX##XX..XXXXXXXX..XX////
##XX##XX..XXXXXXXX..XX////
##XX##..........XX..##QQXX
##XX##..........XX..##QQXX
######XX..XXXX....QQ####XX
######XX..XXXX....QQ####XX
XX##XXXX..........XXQQ##XX
XX##XXXX...XXXX...XXQQ##XX
XX####XX1..Xs.X.2...XX##XX
XX####XX...X..X.....XX##XX
</tiles>
</level>