<?xml version="1.0" encoding="utf-8"?>
<level>
  <tiles>R///////XX//R///XX//////R/
////////XX//////XX////////
//######XX................
//######XX..........QQQQQQ
QQ######//////////////////
QQ######//////////////////
~~######......XX..XXXXXXXX
~~######......XX..XXXXXXXX
~~######XXXXXXXX..XX...X..
~~######XXXXXX....XX...X..
~~######....XX.........X..
~~######....XX.........X..
~~##////////QQQQQQ////##//
~~##////////QQQQQQ////##//
~~................########
~~XX..XX..........########
QQXXXXXXX..XXXXXXX########
QQXXXXXXX..X......########
XX........XX......########
XX........XX..XXXX########
XX....Q.......XXXX~~####~~
XX....Q...........~~####~~
XXXX..Q...........######~~
XXXX..Q....XXXX...######~~
QQXXXXXX1..Xs.X.2.XXXX....
QQXXXXXX...X..X...XXXX....
</tiles>
</level>