<?xml version="1.0" encoding="utf-8"?>
<level>
  <tiles>R...XXXX....R...........R.
....XXXX..................
......XX.....Q....XXXX....
QQ....XX.....Q....XXXX....
~~~~........XX####XXXX////
~~~~........XX####XXXX////
~~~~..////..X.####....////
~~~~..////..X.####....////
....X.////....XX..XX......
....X.////....XX..XX....QQ
....XXXX....////......XX..
....XXXX....////......XX..
////XXXX....////QQXX..~~~~
////XXXX....////QQXXQQ~~~~
////....QQXXXX////XX..~~~~
////....QQXXXX////XX..~~~~
.....QQ.....QQQQ..##QQ....
.....QQ.....QQQQ..##QQ....
........QQ##QQQQ..####....
........QQ##QQQQ..####....
XX..XX..####......QQ......
XX..XX..####........XX....
QQ..XXXX............XXXX..
QQ..XXXX...XXXX.....XXXXQQ
XXXX.Q..1..Xs.X.2...QQ####
XXXX.Q.....X..X.....QQ####
</tiles>
</level>