<?xml version="1.0" encoding="utf-8"?>
<level>
  <tiles>R...........R...........R.
........XXXX..XXXX........
..QQXXXX..######..XXXXQQ..
..QQXXXX..######..XXXXQQ..
..////##..........####//..
..////##..........####//..
Q.//////..//XX//..####////
Q.//////..//XX//..####////
..//##XX//......//XX##//..
..//##XX//......//XX##//..
..//##XXXX..XX~~//XXQQ//QQ
..//##XXXX....~~//XXQQ//QQ
QQ//##XX//XX....//XX##//..
QQ//##XX//XXXX..//XX##//..
..//##..//......////..//..
..//##..//......////..//..
X.//##..////QQ//////..////
X.//##..////QQ//////..////
////##..////////////..////
////##..////////////..////
..QQQQXXQQQQ..QQXXXXQQQQ..
..QQQQXXQQQQ..QQXXXXQQQQ..
..........................
...........XXXX...........
Q.....XX1..Xs.X.2.QQ.....Q
Q.....XX...X..X...QQ.....Q
</tiles>
</level>