<?xml version="1.0" encoding="utf-8"?>
<level>
  <tiles>R.....XXXX..R.....~~....R.
......XXXX........~~......
~~~~..~~~~~~~~~~..~~..~~~~
~~~~..~~~~~~~~~~..~~..~~~~
##....XX..........~~......
##....XX..........~~......
##~~~~~~##~~XX~~##~~~~~~..
##~~~~~~##~~XX~~##~~~~~~..
XX~~XX####XX....##XX##....
XX~~XX####XX....##XX##....
##....~~~~~~..~~~~~~##~~~~
##....~~~~~~..~~~~~~##~~~~
##~~..~~....XX..##XX##....
##~~..~~....XX..##XX##....
QQQQ..QQ..XXQQQQ##.XQQQQ..
......QQ..XX..QQ##.XQQQQ..
......QQ..XX....QQXXXX####
......QQ..XXXX..QQXXXX####
...QXXQQQQXXQQ..XXXXXXQQXX
...QXX..QQXX....XXXXXX..XX
....XXXX........XX........
....XXXX........XX........
................XXXXXXXX..
QQ.........XXXX.XXXXXXXX..
QQQQ....1..Xs.X.2.........
QQQQQQQQ...X..X.........QQ
</tiles>
</level>