<?xml version="1.0" encoding="utf-8"?>
<level>
  <tiles>R.XX....XXXXRX..........R.
..XX....XXXXXX............
......//XX......XXXXQQ....
....XX//XX......XXXXQQ....
QQ..XX//....XX..//....//##
QQ..XX//....XX..//....//##
########XX##XXXX//~~~~//~~
########XX##XXXX//~~~~//~~
####..//XX..//////~~////..
####..//....//////~~////..
....XX//~~~~//~~~~~~//XXXX
....XX//~~~~//~~~~~~//XXXX
XXXX..//~~XXXXXXX.////..//
XXXX..//~~XXXXXXX.////..//
......//~~........//.QQ.//
......//~~........//.QQ.//
~~~~~~//~~XXQQXXQQXX.Q..//
~~~~~~//~~XXQQXXQQXX.Q..//
.....................QXXXX
......XXXX...........QXXXX
QQ......XXXXXXXXXX........
QQ......XX......XXXX......
XXXXXX..QQ........XXXX....
XXXX....QQ.XXXX.....XX....
XX..QQ..1..Xs.X.2.....XX..
....QQ.....X..X.......XX..
</tiles>
</level>