<?xml version="1.0" encoding="utf-8"?>
<level>
  <tiles>R.////////.XR.X.####////R.
..////////.X..X.####////..
//X..Q..X........X##X..X##
//X..Q..X........X##X..X##
//X..Q..X...XX...X##X..X##
//X..Q..X...XX...X##X..X##
//XX....XXXXQQXXXX##..XX##
//XX....XXXXQQXXXX##..XX##
//.....XQQXXXXX.XXQ...####
//.....X....XXX...Q...####
XXXXX.....##XX##.....XXXXX
XXXXX.....##XX##.....XXXXX
~~//////.X######X.//////~~
~~//////.X######X.//////~~
QQXXXX..XX######XX.XXXXXQQ
QQXXXX....######...XXXXXQQ
QQQQQQ......##......QQQQQQ
........XX..##..XX........
//XX////XX......QQ////////
//XX////XX......QQ////////
##XXX.....XX..XX.....XXX##
##XXX................XXX##
....XX..............######
...........XXXX.....######
....QQ..1..Xs.X.2.....####
....QQ.....X..X.....XX####
</tiles>
</level>